0,0,0,0,0,0,0,0,0,0,0,0,0,0,0,0,0,0
0,1,1,1,8,1,1,0,0,1,0,1,1,4,1,1,1,0
0,1,1,1,1,1,0,1,0,1,1,0,1,1,1,1,1,0
0,1,1,1,1,0,6,1,0,1,1,2,0,1,1,1,1,0
0,1,1,1,0,1,1,1,0,1,1,1,1,0,1,1,1,0
0,0,0,0,0,0,0,0,0,0,0,0,0,0,0,0,0,0
0,1,1,1,1,0,7,1,0,1,1,3,0,1,1,1,1,0
0,1,1,1,1,1,0,1,0,1,1,0,1,1,1,1,1,0
0,1,1,1,9,1,1,0,0,1,0,1,1,5,1,1,1,0
0,0,0,0,0,0,0,0,0,0,0,0,0,0,0,0,0,0
